##########
#P.o.....#
########E#
#@......o#
##########