####################
#..................#
#....###...##....###
#.....##....#.....##
#......#....#......#
#..#.......##......#
#.##......####.....#
########....######.#
##.###........####.#
#..####.....######.#
#.#####.....######.#
#...#######........#
#.........#........#
#########.......####
#.................##
#...###########..###
#..#################
#.##################
#E##################
#..................#
####################