####################
#P................o#
#....###...##....###
#.....##....#.....##
#......#....#......#
#..#.......##......#
#.##......####.....#
########....######.#
##o###........####.#
#..####.....######D#
#.#####....E######.#
#...#######........#
#.........#........#
#########.......####
#.................##
#...###########..###
#..#################
#.##################
#E##################
#.................@#
####################